1111111111111111111
1000000000C00000001
1011101010000010101
1010001010000010101
1011101010101010101
1010001010010011001
1010001010101010101
1010001010000010101
1010001110000010101
100P000000000000B01
1010100100010011101
1010101110111010101
1010101111111010101
1010101111111010101
10010B0111110010101
1001000011100010101
100100000100E011101
100000B000000000001
1111111111111111111