1111111111111111111111111111111111111
1000000000000000000000000000000000001
1000000000000000000000000000000000001
1000001111111100000111100000000000001
1000001111111100000111100000000000001
1000000000000011111000011111100000001
1000000000000011111000011111100000001
1000000001111110000000011111100000001
1001111111111111111111111111111111001
1000000001111110000000011111100000001
1000011111000000000000011111100000001
1000011111000000000000011111100000001
1000000000111111110000011111100000001
1000000000111111110000011111100000001
1000000000000000000000000000000000001
1111111111111111111111111111111111111
//karrrrta