1111111111111111111111111111111111111
1000000000000000000000000000000000001
100000000000000B000000000000000000001
1000000111111100000011100000000000001
10000001111111000000111000000000C0001
1000000000000011100000011110000000001
1000000000000011100000011110000000001
1000000001111110000000011110000000001
1001111111111111111111111111111111001
1000000001111110000000011110000000001
1000001111000000000B00011110000000001
1000001111000000000000011110000000001
1000000000111111100000011110000000001
1000000000111111100000011110000000001
10000P0000000000000000000000000000001
100000000B000000000000000E00000000001
1111111111111111111111111111111111111