1111111111111
10B0000000001
1000111000111
10P0011111001
1000C00000001
1000000E01111
10000B0000001
1111111111111