1111111111111
10000000B0001
1000111000111
10P0011111001
1000C00000001
1000000E01111
1000B00000001
1111111111111