 11111111111111111111111111111111111111
 10000000000000000000000000000000000001
 10000000000000000000000000000000000001
 10000000000000000111111100000000011101
 10000000000000000000000000000000000001
 10000000000000000000000000000000000001
 10000000000000000111111100000000011101
 100000000C0000000000000000000000000001
 10000000000000000000000000000000000001
 10000000000000000111111100000000011101
 10000000000000000000000000000000000001
 1000000P000000000000000000000000000001
 10000000000000000111111100000000011101
 10000000000000000000000000000000000001
 100000000000000000000B0000000000000001
 10000000000000000111111100000000011101
 10000000000000000000000000000000000001
 10000000000000000000000000E00000000001
 10000000000000000111111100000000011101
 10000000000000000000000000000000000001
 10000000000000000000000000000000000001
 10000000000000000111111100000000011101