1111111111111111111
1000000000000000001
1111111111000111111
100000P000000000001
1111111111000111111
1000000000000000E01
1111111111000111111
1000000000000000001
1111111111000111111
1000000000000000001
1111111111100011111
100C000000000000001
1111111111111111111